11111111111111111111111111111111111111111111111111111111111111111111111111111111111111111111111111111111111111111111111111111111111111111
1....................................5.................5100000000000000000000000000000000000000000000000004000000000000000000000000000001
1.000000000000000005000000000000000005000000000000000005100000000000004440000000000000000000000000000000024200000000000000000000000000001
1.000000000000000005000000000000000005000000000000000005100000000000000000000000000000000000000000000000002000000000000000000000000000001
1.000000000000000005000000000000000005000000000000000005100000000222222222222220000000000000000000000002000002000000000000200000000000001
1.000000000000000005000000000000000005000000000000000005100000000000000000000000000000000000000000000002000002000000000000200000000000001
1.000000000000000005000000000000000005000000000000000005100000000000000000000000000000000000000000000002000002000000000000200000000000001
1.000000000000000005000000000000000005000000000000000005100000000000000000000000000000000000020000000002000002000000000000200000000000001
1.000000000000000005000000000000000005000000000000000005100000200000000000000000000440000000020000000002000002000000000000000000000000001
1.000000000000000005000000000000000005000000000000000005100000200000000000000000044440000000020000000002000002000000000000000020000000001
1.000000000000000005000000000000000005000000000000000005100000200000400000000000044400000000020000000002000002000000000000000020000000001
1.000000000000000005000000000000000005000000000000000005100000200004400020000000000000000000020000000002000002000000000000000020000000001
1.000000000000000005000000000000000005000000000000000005100000200004400020000000000000000000020000000002000002000000022220000020000000001
1.000000000000000000000000000000000000000000000000000005100000200044400020000000000000000000020000000000000000000000000000000020000000001
1.000000000000000000000000000000000000000000000000000005100000000004400020000000000000000000020000000000000000000000000000000000000000001
1.000000000000000005000000000000000000000000000000000005100000000000000020000002222222200000020000000000000000000000000000000000000000001
15555555555555555555000000000000000000000000000000000005100000000000000020000000000000000000000000000000000000000000000000000000000000001
1.000000000000000000000000000000000005000000000000000005100000000000000020000000000000000444444400000222222222222000000000000000000200001
1.000000000000000000000000000000000005000000000000000005100000000000000020000000000000000444444000000000000000000000000000000000002000001
1.000000000000000000000000000000000005555555555555555555100000200000000020000000000000000000000000000000000000000000000000000000020000001
1.00000000000000000000000000000000000000000000000000000.100000020000000020000000000000000000000000000000000000000000000000000000200000001
1.00000000000000000000000000000000000000000000000000000.100000002000000020000000000222222222222222220000000000000000000000000002000000001
1.00000000000000000000000000000000000000000000000000000.100000000200000000000000000000000000000000000000000002000000000000000020000000001
1.00000000000000000000000000000000000000000000000000000.100000002000000000000000000000000000000000000000000002000000000000000200044000001
1555555555555555555000000000000000000000000000000000000.100000020000000000000000000000000000000000000000000002000000000000002000480400001
1.00000000000000005000000000000000000000000000000000000.100000200000000000000000000000000000000000000000000002000000000000020000400000001
1.00000000000000005000000000000000000000000000000000000.100000000000000000000000000000000000000000000000000002000000000000200000040000001
1.00000000000000005000000000000000000000000000000000000.100000000000000000000000000000000000000000000000000002000000000002000000000000001
1.000000000000000050000000000000000000000055555555555555100000000000000000000000000000000000000000000000000002000000000000000000000000001
1.000000000000000050000000000000000000000050000000000000100000000000000000000000000000000000000000000000000002000000000000000000000000001
1.000000000000000050000000000000000000000050000000000000100000000000000000000000000000000000000000000000000000000000000000000000000000001
1.000000000000000050000000000000000000000050000000000000111111111111111111111111111111111111111111111000000000000000000111111111111111111
1.000000000000000050000000000000000000000050000000000000000000000000000000500000000000000000000000000000000000000000000000000000000000001
1.000000000000000050000000000000000000000050000000000000000000000000000000500000000000000000000000000000000000000000000000000000000000001
1.000000000000000050000000000000000000000050000000000000000000000000000000500000000000000000000000000000000000000000000000000000000000001
1.000000000000000000000000000000000000000050000000000000000000000000000000500000000000000000000000000000000000000000000000000000000000001
1.000000000000000000000000000000000000000050000000000000000000000000000000500000000000000000000000000000000000000000000000000000000000001
1.000000000000000000000000000000000000000050000000000000000000000000000000500000000000000000000000000000000000000000000000000000000000001
1.000000000000000000000000000000000000000050000000000000000000000000000000500000000000000000000000000000000000000000000000000000000000001
1.000000000000000050000000000000000000000050000000000000000000000000000000500000000000000000000000000000000000000000000000000000000000001
1.000000000000000050000000000000000000000050000000000000000000000000000000500000000000000000000000000000000000000000000000000000000000001
1.000000000000000050000000000000000000000050000000000000000000000000000000500000000000000000000000000000000000000000000000000000000000001
1.000000000000000050000000000000000000000000000000000000000000000000000000500000000000000000000000000000000000000000000000000000000000001
1.000000000000000050000000000000000000000000000000000000000000000000000000500000000000000000000000000000000000000000000000000000000000001
1.555555555555555550000000000000000000000000000000000000000000000000000000500000000000000000000000000000000000000000000000000000000000001
1.000000000000000000000000000000000000000000000000000000000000000000000000500000000000000000000000000000000000000000000000000000000000001
1.000000000000000000000000000000000000000000000000000000000000000000000000500000000000000000000000000000000000000000000000000000000000001
1.000000000000000000000000000000000000000000000000000000000000000000000000500000000000000000000000000000000000000000000000000000000000001
1.000000000000000000000000000000000000000000000000000000000000000000000000500000000000000000000000000000000000000000000000000000000000001
1.000000000000000000000000000000000000000000000000000000000000000000000000500000000000000000000000000000000000000000000000000000000000001
1.000000000000000000000000000000000000000050000000000000000000000000000000500000000000000000000000000000000000000000000000000000000000001
1.000000000000000000000000000000000000000050000000000000000000000000000000510000000000000000000000000000000000000000000000000000000000001
1.000000000000000000000000000000000000000050000000000000000000000000000000500000000000100000000000000000000000000000000000000000000000001
1.000000000000000000000000000000000000000050000000000000000000000000000000500000000000000000000000000000000000000000000000000000000000001
1.000000000000000000000000000000000000000050000000000000000000000000000000500000000000000000000000000000000000000000000000000000000000001
1.000000000000000000000000000000000000000055555555555555555555555555555555500000000000000000000000000000000000000000000000000000000000001
1.000000000000000000000000000000000000000000000000000000000000000000000000.00000000000000000000000000000000000000000000000000000000000001
1.000000000000000000000000000000000000000000000000000000000000000000000000.00000000000000000000000000000000000000000000000000000000000001
1.000000000000000000000000000000000000000000000000000000000000000000000000.00000000000000000000000000000000000000000000000000000000000001
1.000000000000000000000000000000000000000000000000000000000000000000000000.00000000000000000000000000000000000000000000000000000000000001
1.000000000000000000000000000000000000000000000000000000000000000000000000.00000000000000000000000000000000000000000000000000000000000001
1.000000000000000000000000000000000000000000000000000000000000000000000000.00000000000000000000000000000000000000000000000000000000000001
1.000000000000000000000000000000000000000000000000000000000000000000000000.00000000000000000000000000000000000000000000000000000000000001
1.<<<<<<<<<<<<<<<<<<<<<<00000000000000<<<<<<<<<<<<<<<<<<<<<<<<<<<<<<<<<<<<<00000000000000000000000000000000000000000000000000000000000001
1.000000000000000000000000000000000000000000000000000000000070000000000007<00000000000000000000000000000000000000000000000000000000000001
1.000000000000000000000000000000000000000000000000000000000070000000000007<00000000000000000000000000000000000000000000000000000000000001
1.0000000000000000000000000000000000000000000000000000000000,0000000000007<00000000000000000000000000000000000000000000000000000000000001
1.0000000000000000000000000000000000000000000000000000000000,0000000000007<00000000000000000000000000000000000000000000000000000000000001
1.000000000000000000000000000000000000000000000000000000000070000000000007<00000000000000000000000000000000000000000000000000000000000001
1.000000000000000000000000000000000000090000000000000000000070000000000007<00000000000000000000000000000000000000000000000000000000000001
1.000000000000000000000000000000000000090000000000000000000077,,,770007777<00000000000000000000000000000000000000000000000000000000000001
1777777,,,,,,,,,7777700000000000000000090000000000000000000000000000000000<00000000000000000000000000000000000000000000000000000000000001
17000000000000000000700000000000000000090000000000000000000000000000000000<00000000000000000000000000000000000000000000000000000000000001
17000000000000000000,00000000000000000000000000000000000000000000000000000000000000000000000000000000000000000000000000000000000000000001
17000000000000000000,00000000000000000000000000000000000000000000000000000000000000000000000000000000000000000000000000000000000000000001
17000000000000000000700000000000000000000000000000000000000000000000000000000000000000000000000000000000000000000000000000000000000000001
17000000000000000000700000000000000000000000000000000000000000000000000000000000000000000000000000000000000000000000000000000000000000001
17000000000000000000700000000000000000000000000000000000000000000000000000000000000000000000000000000000000000000000000000000000000000001
170000000000000000000000000000000000000000000000000000000777777,,,,,,,7777<>>>>>>>>>>>>>>000000000000000000000000000000000000000000000001
17000000000000000000000000000000000000000000000000000000070000000000000007<>000000000000>000000000000000000000000000000000000000000000001
17000000000000000000000000000000000000000000000000000000070000000000000007<>000000000000>000000000000000000000000000000000000000000000001
170000000000000000000000000000000000000000777,,,,7770000770000000000000007<>000000000000>000000000000000000000000000000000000000000000001
17000000000000000000000000000000000000000070000000000000000000000000000007<>000000000000>000000000000000000000000000000000000000000000001
17000000000000000000000000000000000000000070000000000000000000000000000007<>000000000000>000000000000000000000000000000000000000000000001
17000000000000000000700000000000000000000070000000000000000000000000000007<>0000000000000000000000000000000000000000000000000000000000001
17000000000000000000,00000000000000000000070000000000000000000000000000007<>0000000000000000000000000000000000000000000000000000000000001
17000000000000000000,00000000000000000000070000000000000000000000000000007<>0000000000000000000000000000000000000000000000000000000000001
17000000000000000000700000000000000000000070000000000000000000000000000007<>000000000000>000000000000000000000000000000000000000000000001
177777777777777777777.....................77777777777777777777777777777777<>>>>>>>>>>>>>>000000000000000000000000000000000000000000000001
11111111111111111111111111111111111111111111111111111111111111111111111111111111111111111111111111111111111111111111111111111111111111111
