111111111111111111111111111111111111111111111111111111111111111111111111
100000000000000133333333333333333333333333333333333333333333333333333331
100000000000000130000000000000000003333000000000033000000000000033333331
100111111111100130000000000000000000000000000000033000000000000030000031
100000100000000130003333333333333000000003333003333300333333330030000031
110000100000000130003333333333333003333003333003333300333333330030030031
110011110011111130003300000000003003333003333003333300330000000030030031
110000000011111130003300000000003003333003333003333300330000000030030031
100000000011111130003300333300333003333003333003333300333333333330030031
100111111111111130003300333300333003333003333000000000000000000000030031
100000100000000130003300333300333003333003333000000000000000000000030031
100000100000000130003333333300333003333003333333333330033333333333330031
111100100000000130003333333300333003333000000000000030033333333333330031
111100100000000130000000033300000003333000000000000030000000000000030031
110000000011100130000000033300000003333300333333330030000000000000030031
110000000011100130000000033300333333300300333300330033333330033330030031
110011111111100130000000033300333333300300333300330000033330033330030031
110011111111100130000000033300000000000300000000330000033000033330030031
110000011000000130000000033300000000000300000000330000033000033330030031
110000011000000133300333333333333333333333333333333330033333333333333331
111110011001111122200222222222222220000000000000000000000000000000000001
122220022000000002200002200000000020000000000000000000000000000000000001
120000022000000002200002200000000020021111120000000000000000000000000001
120000022222222002222002200222220020012000012000000000000000000000000001
122200022222222002222002200222220020010200010200000000000000000000000001
122200022000022000022002200000220020010024444420000000000000000000000001
120000022000022000022002200000220020010040010040044404440404000000000001
120002222002222220022002222200220020010040010040040404040040000000000001
122002222000000220022000000200220020021141120040044004440040000000000001
122000000002200220022000000200220020012040002040040404040040000000000001
122000000002200220022222200200220020000240000240040404040040000000000001
122000022002200220022222200000220020000024444420040404040040000000000001
122000022002222220022002200000220020000000000000000000000000000000000001
120000022002222220022002200222220020000000000444044404440444044404440001
120020022002200000022002200222220020000000000400040404000040040004040001
120020022002200000022002200220020020000000000400044404000040040004400001
120020022222222222222002200220020020000000000400040404440040044404040001
120020022222222222222002200220000020000000000400040400040040040004040001
120020000000000000000002200222220020000000000444040404440040044404040001
120020000000000000000002200222220020000000000000000000000000000000000001
120022222222222200222222200222220020000000000000000000000000000000000001
120022002222222200222222200222220020004440400040400000000000000000000001
120022002200222200220000000222220020000400440440400000000000000000000001
120022002200222200220000000222220020000400405040400000000000000000000001
120000002200000000000000000000000020000400400040400000000000000000000001
120000002200000000000000000000000020004400400040444000000000000000000001
122222222222222222222222222222222220000000000000000000000000000000000001
111111111111111111111111111111111111111111111111111111111111111111111111
