1111111111111111111111111111111111111111111111111111111111111111111111111
1000000000000000000000000000000000000000000000000033333333333333333300088
1000000000000000000000000000000000000000000000000038888888888888888389008
1000000000000000000000000000000000000000000000000038000000000000008380008
1000000333330000000000000000000000000000000000000038000000000000008388008
1000000300000000000000000000000000000000000000000038000000000000008380008
1000000300000000000000000000000000000000000000000038000000000000008380008
1000000300000000000000000000000000000000000000000038000000000000008380008
1000000300033344333300000000000000000000003000300038000000000000008380088
1000000300088844888300000000000000000000003000300038000000000000008380008
1000000300000000008300000000000000000000003000334438000000000000008380008
1000000380000000008300000000000000000000003000000000000000000000008380008
1000000380000000008300000000000000000000003000000000000000000000008388008
1000000380000000008300000000000000000000003000000000000000000000008380008
1000000380000000008300000000000000000000003000334438000000000000008380008
1000000380000000008300000000000000000000003000300038000000000000008380008
1000000380000000008300000000000000000000003000300038000000000000008380008
1000000388444888008300000000000000000000000000000038000000000000000380088
1000000333444338888300000000000000000000000000000038888884444888880080008
1000000000000033333300000000000000000000000000000033333334444333333080008
1000000000000000000000000000000000000000000000000000000000000000001080008
1000000000000000000000000000000000000000000000000000000000000000001080008
1000000000000000000000000000000000000000000000000000000000000000001080008
1000000000000000000000000000000000000000000000000000000000000000001080008
1000000000000000000000000000000000000000000000000000000000000000001080008
1000000000000000000000000000000000000000000000000000000000000000011088808
1000000000000000000000011111111100000000111112222211111111122121210011108
1000000000000000000000010000000000000000000000000000000550000007770705508
1000000000000000000000010000000000000000000000000000000550000507000705508
1000000000000000000000010000000000000000000000000000000550000507000700008
1000000000000000000000010000000000000000000000000000000550000507000755058
1000000000000000000000010000000000000000000000000000000556655507000705058
1000000000000000000000010000000000000000000000000000000550005007000705058
1000000000000000000000010000000000000000000000000000000550555007000775058
1000000000000000000000010000000000333000000000000000000550500055700075051
1000000000000000000000010000000033000110000000000000000550600055700070001
1000000000000000000000010000000300000003000000000000000050605555700000001
1000000000000000000000010000003000000000100000000000000050605555700000001
1000000000000000000000010000003000000000100000000000000050505500000070001
1000000000000000000000010000030000000000030000000000000550500000000075001
1000000000000000000000010000030000000000010000000000000550550000000075001
1000000000000000000000010000030000000000010000000000000550500700000775001
1000000000000000000000010000001000000000300000000000000550000700000755001
1000000000000000000000010000003000000000300000000000000550557700007755001
1333443330000000334433110000000300000003000000000000000550570000007500001
1888448888800088884488810000000033000130000000000000000550770000007505001
1800008000000080000000810000000000113000055000000000000550700000077555001
1800008080000080000000810000000000000000557000000000000557700000770550001
1800008080000088800088810000000000000000557005555550000577000007700000001
1800008080000000000000810000000000000005557007550055555570000077555555651
1800008080000000000000810000000000000005557007775055555750000775000600051
1800008080000000000000810000000000000055557000075000055700000705050500061
1800000080000000000000810000000000000055557000077700006600000500050000061
1800008088888888000000810000000000005555557000000770000000700556656550061
1800008880000008000000810000000000055555505700000070000000700000000000051
1800000080000008000000810000000000555555506700000000000007555000005555551
1800000080000008000008810000000555555555506570000000000000775555555777771
1888008888800888880888110000055555555555500577700000000000007777777700071
1800000080000008000008110000555555555555500055577000000000000000000000071
1800000000000000000008110005555555555555555000055700007000000000000000071
1800000000000000000008110055555555555555506650007700007777770000000777771
1800000080000008000008111115555555555555500055000000007555577777777766661
1888888888888888888888111115555555555555500000000000000000000000000000001
1111111111111111111111111111111111111111111111111111111111111111111111111
