1111111111111111111111111111111111111111111111111111111111111111111111111
1000000000000000000000000000000000000000000000000033333333333333333388888
1000000000000000000000000000000000000000000000000038888888888888888389008
1000000000000000000000000000000000000000000000000038000000000000008380008
1000000333330000000000000000000000000000000000000038000000000000008388008
1000000300000000000000000000000000000000000000000038000000000000008380008
1000000300000000000000000000000000000000000000000038000000000000008380008
1000000300000000000000000000000000000000000000000038000000000000008380008
1000000300033333333300000000000000000000003000300038000000000000008380088
1000000300088888888300000000000000000000003000300038000000000000008380008
1000000300000000008300000000000000000000003000333338000000000000008380008
1000000380000000008300000000000000000000003000000000000000000000008380008
1000000380000000008300000000000000000000003000000000000000000000008388008
1000000380000000008300000000000000000000003000000000000000000000008380008
1000000380000000008300000000000000000000003000333338000000000000008380008
1000000380000000008300000000000000000000003000300038000000000000008380008
1000000380000000008300000000000000000000003000300038000000000000008380008
1000000388888888008300000000000000000000000000000038000000000000008380088
1000000333333338888300000000000000000000000000000038888888888888888380008
1000000000000033333300000000000000000000000000000033333333333333333380008
1000000000000000000000000000000000000000000000000000000000000000001180008
1000000000000000000000000000000000000000000000000000000000000000001180008
1000000000000000000000000000000000000000000000000000000000000000001180008
1000000000000000000000000000000000000000000000000000000000000000001180008
1000000000000000000000000000000000000000000000000000000000000000001180008
1000000000000000000000000000000000000000000000000000000000000000001188808
1000000000000000000000011112221100000000111112222211111111122121211111108
1000000000000000000000010000000000000000000000000000000550000007777705505
1000000000000000000000010000000000000000000000000000000550000507000705505
1000000000000000000000020000000000000000000000000000000550000507000700005
1000000000000000000000020000000000000000000000000000000550000507000755055
1000000000000000000000020000000000000000000000000000000556655507000705055
1000000000000000000000020000000000000000000000000000000550005007000705055
1000000000000000000000010000000000000000000000000000000550555007000775055
1000000000000000000000010000000000333000000000000000000550500055700075055
1000000000000000000000010000000033000440000000000000000550600055700070005
1000000000000000000000010000000300000003000000000000000550605555700000005
1000000000000000000000010000003000000000300000000010000550605555700000005
1000000000000000000000010000003000000000400000000110000550505500000070005
1000000000000000000000010000030000000000030000000100000550500000000075005
1000000000000000000000020000030000000000040000000000000550550000000075005
1000000000000000000000010000030000000000040000000000000550500700000775005
1000000000000000000000010000004000000000300000000000000550000700000755005
1000000000000000000000010000003000000000300000000000000550557700007755005
1333333330000000333333310000000300000003000000000000000550570000007500005
1888888880000000888888820000000033000430000000000000000550770000007505005
1800000000000000000000810000000000443000055000000000000550700000077555005
1800000000000000000000810000000000000000557000000000000557700000770550005
1800000000000000000000810000000000000000557005555550000577000007700000005
1800000000000000000000810000000000000005557007550055555570000077555555655
1800000000000000000000820000000000000005557007775055555750000775000600055
1800000000000000000000820000000000000055557000075000055700000705050500065
1800000000000000000000820000000000000055557000077700006600000500050000065
1800000000000000000000810000000000005555557000000770000000700556656550065
1800000000000000000000810000000000055555505700000070000000700000000000055
1800000000000000000000810000000000555555506700000000000007555000005555555
1800000000000000000000810000000555555555506570000000000000775555555777775
1800000000000000000000810000055555555555500577700000000000007777777700075
1800000000000000000000810000555555555555500055577000000000000000000000075
1800000000000000000000810005555555555555555000055700007000000000000000075
1800000000000000000000810055555555555555506650007700007777770000000777775
1800000000000000000000810555555555555555500055000000007555577777777766665
1888888888888888888888815555555555555555500000000000000000000000000000005
1111111111111111111111115555555555555555555555555555555555555555555555555
